9 10
**********
*  S     *
******** *
*        *
* *** ****
*  *     *
*  ****  *
*   G *  *
**********

