21 18
******************
*  S             *
******** ******* *
*        *       *
* *** ******* ****
*  *  *    *     *
*  ****    ****  *
*                *
************* ****
*  *       *     *
*  ****    ****  *
*     *          *
* *** *** *** ****
*  *       *     *
*  ****    ****  *
*     *          *
* *** ******* ****
*  *       *     *
*  ****    ****  *
*     *     G *  *
******************

